1111111111111
1010000000B01
1C00E11110001
10P0110000001
1111111111111