1111111111111
1C10000000B01
100E011110001
10P0110000001
1111111111111