11111111
1C000001
10000001
100BE001
1B0P00B1
11111111