11111111
1C100001
10P00001
10C00001
10CEB001
11111111