11111111
1C100001
10P00001
10C0B0B1
10CEB001
11111111