11111111
1C0BC001
110BB001
100B0E01
1B0P00B1
11111111