11111111111111111111111
1C11B0C00000CCBC100B111
10B00CB0000B00000000111
10000BCCEB111B0000P0111
11111111111111111111111