11111111111111111111111
1C11B0C00000CCBC100B111
10B00CB0000B00000000111
10P00BCCEB111B000000111
10000000000000000000001
10000000000000000000001
10000000000000000001001
11111111111111111111111