1111111111111
1C110000001C1
1000011110001
10P011E000001
1111111111111