11111111111111111111111
1CCCCBCC11CCCCCB1CBCBE1
1CB1CCCCCCBC11C1BCCCCC1
1CC11111111CBCC1CC11111
1BCCCCCBCCC1C11CCC1CCC1
111111CCCBC1C1CBC1CCBC1
1CCCC1C11111CCC11CB1111
1BCBCCC1CCCC111CCBCCCC1
1BC1C111CC1BCC1C1CC1CB1
11C111CCBC1CC1CC1C11CB1
1BCCCCBC11BCCCC1BC1BCP1
11111111111111111111111