1111111111111111111111111111111
11BCCCCBCCBCCCC1CCCCBCCCCCBCC11
1CCBCCCBCC1CC1CCC1111CCCBCCBCC1
1B1CC1C11C1CC1CCC1CE1C11C1CC1C1
1C1CC1C11C1111CCBCC1CC11C1CC1C1
1CCCBCCCCCCCC1CBCC1CCCCCCCCCCC1
1111CC111CCCC1CCB1111C111BC1111
1PCCBCCCCCBCCCCCCCCCCCCCCBCCCC1
1111111111111111111111111111111